50 50
**^^^^^^^^^^^^^^^^^^^^^^^^^^^^^^^^^^^^^^^^^^^^^^^^
**^^^^^^^^^^^^^^^^^^^^^^^^^^^^^^^^^^^^^^^^^^^^^^^^
**^^^^^^^^^^^^^^^^^^^^^^^^^^^^^^^^^^^^^^^^^^^^^^^^
***^^^^^^^^^^^^^^^^^^^^^^^^^^^^^^^^^^^^^^^^^^^^^^^
***^^^^^^^^^^^^^^^^^^^^^^^^^^^^^^^^^^^^^^^^^^^^^^^
***^^^^^^^^^^^^^^^^^^^^^^^^^^^^^^^^^^^^^^^^^^^^^^^
***^^^^^^^^^^^^^^^^^^^^^^^^^^^^^^^^^^^^^^^^^^^^^^^
***^^^^^^^^^^^^^^^^^^^^^^^^^^^^^^^^^^^^^^^^^^^^^^^
....TTTTTT##^^^^^^^^^^^^^^^^^^^^^^^^^^^^^^^^^^^^^#
....TTTTTT###^^^^^^^^^^^^^^^^^^^^^^^^^^^^^^^^^^^^#
.....TTTTTT###^^^^^^^^^^^^^^^^^^^^^^^^^^^^^^^^^^^#
.....TTTTTT#####^^^^^^^^^^^^^^^^^^^^^^^^^^^^^^^^##
......TTTTTT#####^^^^^^^^^^^^^^^^^^^^^^^^^^^^^^^##
......TTTTTTT#####^^^^^^^^^^^^^^^^^^^^^^^^^^^^^^##
.......TTTTTTTT####^^^^^^^^^^^^^^^^^^^^^^^^^^^^###
........TTTTTTTT###^^^^^^^^^^^^^^^^^^^^^^^^^^^^^##
........TTTTTTTTT###^^^^^^^^^^^^^^^^^^^^^^^^^^^###
.........TTTTTTTTT##^^^^^^^^^^^^^^^^^^^^^^^^^#####
..........TTTTTTTT###^^^^^^^^^^^^^^^^^^^^^########
...........TTTTTTT###^^^^^^^^^^^^^^^^^^^#########^
............TTTTTTT###^^^^^^^^^^^^^^^^^#########^^
.............TTTTTT####^^^^^^^^^^^^^^^^#########^^
.............TTTTTTT######^^^^^^^^^^^^##########^^
..............TTTTTTT##########^^^^^^^##########^^
...............TTTTTTTT##########^^#############^^
...............TTTTTTTTTTT#####################^^^
................TTTTTTTTTTTTT##################^^^
................TTTTTTTTTTTTTTTT###############^^^
%%%..............TTTTTTTTTTTTTTTTTTTT##########^^^
.%................TTTTTTTTTTTTTTTTTTTT########^^^^
%.%%%%..............TTTTTTTTTTTTTTTTTTT#######^^^^
%%%%%%%...............TTTTTTTTTTTTTTTTTT#####^^^^^
%%%%%%%.................TTTTTTTTTTTTTTTT####^^^^^^
.........................TTTTTTTTTTTTTTT####^^^^^^
...........................TTTTTTTTTTTTT####^^^^^^
............................TTTTTTTTTTTTT###^^^^^^
...............................TTTTTTTTTT####^^^^#
................................TTTTTTTTT#####^^##
.................................TTTTTTTTT########
..................................TTTTTTTT########
..................................TTTTTTTTT#######
..................................TTTTTTTTTT######
..................................TTTTTTTTTTTTT###
***********************************^^^^^^^^^^^^^^^
***********************************^^^^^^^^^^^^^^^
***********************************^^^^^^^^^^^^^^^
***********************************^^^^^^^^^^^^^^^
************************************^^^^^^^^^^^^^^
*************************************^^^^^^^^^^^^^
**************************************^^^^^^^^^^^^