100 100
**^^^^^^^^^^^^^^^^^^^^^^^^^^^^^^^^^^^^^^^^^^^^^^^^^^^^^^^^^^^^^^^^^^^^^^^^^^^^^^^^^^^^^^^^^^^^^^^^**
***^^^^^^^^^^^^^^^^^^^^^^^^^^^^^^^^^^^^^^^^^^^^^^^^^^^^^^^^^^^^^^^^^^^^^^^^^^^^^^^^^^^^^^^^^^^^^^^**
***^^^^^^^^^^^^^^^^^^^^^^^^^^^^^^^^^^^^^^^^^^^^^^^^^^^^^^^^^^^^^^^^^^^^^^^^^^^^^^^^^^^^^^^^^^^^^^^**
***^^^^^^^^^^^^^^^^^^^^^^^^^^^^^^^^^^^^^^^^^^^^^^^^^^^^^^^^^^^^^^^^^^^^^^^^^^^^^^^^^^^^^^^^^^^^^^***
***^^^^^^^^^^^^^^^^^^^^^^^^^^^^^^^^^^^^^^^^^^^^^^^^^^^^^^^^^^^^^^^^^^^^^^^^^^^^^^^^^^^^^^^^^^^^^^***
***^^^^^^^^^^^^^^^^^^^^^^^^^^^^^^^^^^^^^^^^^^^^^^^^^^^^^^^^^^^^^^^^^^^^^^^^^^^^^^^^^^^^^^^^^^^^*****
***^^^^^^^^^^^^^^^^^^^^^^^^^^^^^^^^^^^^^^^^^^^^^^^^^^^^^^^^^^^^^^^^^^^^^^^^^^^^^^^^^^^^^^^^^^^^*****
****^^^^^^^^^^^^^^^^^^^^^^^^^^^^^^^^^^^^^^^^^^^^^^^^^^^^^^^^^^^^^^^^^^^^^^^^^^^^^^^^^^^^^^^^^^^*****
****^^^^^^^^^^^^^^^^^^^^^^^^^^^^^^^^^^^^^^^^^^^^^^^^^^^^^^^^^^^^^^^^^^^^^^^^^^^^^^^^^^^^^^^^^^******
****^^^^^^^^^^^^^^^^^^^^^^^^^^^^^^^^^^^^^^^^^^^^^^^^^^^^^^^^^^^^^^^^^^^^^^^^^^^^^^^^^^^^^^^^^^******
*****^^^^^^^^^^^^^^^^^^^^^^^^^^^^^^^^^^^^^^^^^^^^^^^^^^^^^^^^^^^^^^^^^^^^^^^^^^^^^^^^^^^^^^^^^******
*****^^^^^^^^^^^^^^^^^^^^^^^^^^^^^^^^^^^^^^^^^^^^^^^^^^^^^^^^^^^^^^^^^^^^^^^^^^^^^^^^^^^^^^^^*******
******^^^^^^^^^^^^^^^^^^^^^^^^^^^^^^^^^^^^^^^^^^^^^^^^^^^^^^^^^^^^^^^^^^^^^^^^^^^^^^^^^^^^^^^*******
******^^^^^^^^^^^^^^^^^^^^^^^^^^^^^^^^^^^^^^^^^^^^^^^^^^^^^^^^^^^^^^^^^^^^^^^^^^^^^^^^^^^^^^********
*******^^^^^^^^^^^^^^^^^^^^^^^^^^^^^^^^^^^^^^^^^^^^^^^^^^^^^^^^^^^^^^^^^^^^^^^^^^^^^^^^^^^^^********
.......TTTTTTTTT###^^^^^^^^^^^^^^^^^^^^^^^^^^^^##########^##########TTTTTTTTTTTTTTTTTTTTTTT.........
........TTTTTTTTT###^^^^^^^^^^^^^^^^^^^^^^^^^^##########^##########TTTTTTTTTTTTTTTTTTTTTTTT.........
.........TTTTTTTT###^^^^^^^^^^^^^^^^^^^^^^^^#########^##############TTTTTTTTTTTTTTTTTTTTT...........
..........TTTTTTTT###^^^^^^^^^^^^^^^^^^^^^########^^#^^^^^###########TTTTTTTTTTTTTTTTTTTT...........
...........TTTTTTT###^^^^^^^^^^^^^^^^^^^########^^^^^^^^^^##########TTTTTTTTTTTTTTTTTTTT............
............TTTTTTT###^^^^^^^^^^^^^^^^^^########^^^^^^^^^^###########TTTTTTTTTTTTTTTTTTT............
.............TTTTTT####^^^^^^^^^^^^^^^^##########^^^^^^^^############TTTTTTTTTTTTTTTTTTT............
..............TTTTTT######^^^^^^^^^^^^##########^^^^^^^^^^##########TTTTTTTTTTTTTTTTTTTT............
..............TTTTTTT#########^^^^^^^###########^^^^^^^^^^^#########TTTTTTTTTTTTTTTTTTTT............
...............TTTTTTT###########^^############^^^^^^^^^^^^#########TTTTTTTTTTTTTTTTTTT.............
...............TTTTTTTTTTT#####################^^^^^^^^^^^^^########TTTTTTTTTTTTTTTTTTTT............
................TTTTTTTTTTTTT##################^^^^^^^^^^^^########TTTTTTTTTTTTTTTTTTTTT............
................TTTTTTTTTTTTTTTT###############^^^^^^^^^^^^^######TTTTTTTTTTTTTTTTTTTTTT............
.................TTTTTTTTTTTTTTTTTTT###########^^^^^^^^^^^^^#####TTTTTTTTTTTTTTTTTTTTTTT............
..................TTTTTTTTTTTTTTTTTTTTT#######^^^^^^^^^^^^^^####TTTTTTTTTTTTTTTTTTTTTTTT............
....................TTTTTTTTTTTTTTTTTTTT######^^^^^^^^^^^^^^####TTTTTTTTTTTTTTTTTTTTTTTT............
......................TTTTTTTTTTTTTTTTTT#####^^^^^^^^^^^^^^^####TTTTTTTTTTTTTTTTTTTTTTTTT...........
........................TTTTTTTTTTTTTTTT####^^^^^^^^^^^^^^^^###TTTTTTTTTTTTTTTTTTTTT..TTTT..........
.........................TTTTTTTTTTTTTTT####^^^^^^^^^^^^^^^####TTTTTTTTTTTTTTTTTT.....TTTTT.........
...........................TTTTTTTTTTTTT####^^^^^^^^^^^^^^^####TTTTTTTTTTTTTTTTTT......TTTTT........
.............................TTTTTTTTTTTT###^^^^^^^^##^^^^####TTTTTTTTTTTTTTTTTT........TTTT........
%%%%%%%...........%%%..........TTTTTTTTTT####^^^^^############TTTTTTTTTTTTTTTTTT.........TTT........
%%%%%%..........%%%%%%%.........TTTTTTTTT#####^##############TTTTTTTTTTTTTTTTTTT.........TTTT.......
%%.%...........%%%%%%%%%%........TTTTTTTTT##################TTTTTTTTTTTTTTTTTTT............TTT......
.%............%%%%%%%%%%%%........TTTTTTTT################TTTTTTTTTTTTTTTTTTTTT.............T.T.TT.T
...........%%%%%%%%%%%%%%%%%......TTTTTTTTT#############TTTTTTTTTTTTTTTTTTTTTT...............TTTTTTT
%.........%%%%%%%%%%%%%%%%%%%.....TTTTTTTTTT###########TTTTTTTTTTTTTTTTTTTTTTT...............TTTTTTT
%.......%%%%%%%%%%%%%%%%%%%%%%....TTTTTTTTTTTT#######TTTTTTTTTTTTTTTTTTTTTTTT................TTTTTTT
........%%%%%%%%%%%%%%%%%%%%%%.....TTTTTTTTTTTTTTTTTTTTTTTTTTTTTTTTTTTTTTTTT.................TTTTTTT
........%%%%%%%%%%%%%%%%%%%%%%%....TTTTTTTTTTTTTTTTTTTTTTTTTTTTTTTTTTTTTTTT..................TTTTTTT
.......%%%%%%%%%%%%%%%%%%%%%%%%....TTTTTTTTTTTTTTTTTTTTTTTTTTTTTTTTTTTTTTTT..................TTTTTTT
%.....%%%%%%%%%%%%%%%%%%%%%%%%%....TTTTTTTTTTTTTTTTTTTTTTTTTTTTTTTTTTTTTTTT..................TTTTTTT
%.....%%%%%%%%%%%%%%%%%%%%%%%%%.....TTTTTTTTTTTTTTTTTTTTTTTTTTTTTTTTTTTTTTT..................TTTTTTT
%%..%%%%%%%%%%%%%%%%%%%%%%%%%%%%.....TTTTTTTTTTTTTTTTTTTTTTTTTTTTTTTTTTTTTT..................TTTTTTT
%.%%%%%%%%%%%%%%%%%%%%%%%%%%%%%%......TTTTTTTTTTTTTTTTTTTTTTTTTTTTTTTTTTTTT..................TTTTTTT
%%%%%%%%%%%%%%%%%%%%%%%%%%%%%%%%........TTTTTTTTTTTTTTTTTTTTTTTTTTTTTTTTTTTT................TTTTTTTT
%%%%%%%%%%%%%%%%%%%%%%%%%%%%%%%%...........TTTTTTTTTTTTTTTTTTTTTTTTTTTTTTTTT...............TTTTTTTTT
%%%%%%%%%%%%%%%%%%%%%%%%%%%%%%%%%........................TTTTTTTTTTTTTTTTTTTT..............TTTTTTTTT
%%%%%%%%%%%%%%%%%%%%%%%%%%%%%%%%%..........................TTTTTTTTTTTTTTTTTT.............TTTTTTTTTT
%%%%%%%%%%%%%%%%%%%%%%%%%%%%%%%%%%%..........................TTTTTTTTTTTTTTTT............TTTTTTTTTTT
%%%%%%%%%%%%%%%%%%%%%%%%%%%%%%%%%%%%%..............................TTTTTTTTTTT..........TTTTTTTTTTTT
%%%%%%%%%%%%%%%%%%%%%%%%%%%%%%%%%%%%%%%...............................TTTTTTTT.........TTTTTTTTTTTTT
%%%%%%%%%%%%%%%%%%%%%%%%%%%%%%%%%%%%%%%%%.......%%%%..................TTTTTTTT.........TTTTTTTTTTTTT
%%%%%%%%%%%%%%%%%%%%%%%%%%%%%%%%%%%%%%%%%%%%%%%%%%%%%%..................TTTTTT........TTTTTTTTTTTTTT
%%%%%%%%%%%%%%%%%%%%%%%%%%%%%%%%%%%%%%%%%%%%%%%%%%%%%%%...................TTT........TTTTTTTTTTTTTTT
%%%%%%%%%%%%%%%%%%%%%%%%%%%%%%%%%%%%%%%%%%%%%%%%%%%%%%%%...........................TTTTTTTTTTTTTTTTT
%%%%%%%%%%%%%%%%%%%%%%%%%%%%%%%%%%%%%%%%%%%%%%%%%%%%%%%%%.........................TTTTTTTTTTTTTTTTTT
%%%%%%%%%%%%%%%%%%%%%%%%%%%%%%%%%%%%%%%%%%%%%%%%%%%%%%%%%%.....................TTTTTTTTTTTTTTTTTTTTT
%%%%%%%%%%%%%%%%%%%%%%%%%%%%%%%%%%%%%%%%%%%%%%%%%%%%%%%%%%%%...................TTTTTTTTTTTTTTTTTTTTT
%%%%%%%%%%%%%%%%%%%%%%%%%%%%%%%%%%%%%%%%%%%%%%%%%%%%%%%%%%%%%%%%...............TTTTTTTTTTTTTTTTTTTTT
...............................................................................TTTTTTTTTTTTTTTTTTTTT
..............................................................................TTTTTTTTTTTTTTTTTTTTTT
...............................................................................TTTTTTTTTTTTTTTTTTTTT
...............................................................................TTTTTTTTTTTTTTTTTTTTT
..........................................~....................................TTTTTTTTTTTTTTTTTTTTT
.......................................~~~~~..................................TTTTTTTTTTTTTTTTT####T
......................................~~~~~~~..................................TTTTTTTTTTTTTT######T
....................................~~~~~~~~~~................................TTTTTTTTTTT#########TT
..................................~~~~~~~~~~~~................................TTTTTTTTT###########TT
.................................~~~~~~~~~~~~~~...............................TTTTTTTTT##########TTT
................................~~~~~~~~~~~~~~~~..............................TTTTTTTTT##########TTT
...............................~~~~~~~~~~~~~~~~~~~............................TTTTTTTTT##########TTT
...............................~~~~~~~~~~~~~~~~~~~~~..........................TTTTTTTTT#########TTTT
..............................~~~~~~~~~~~~~~~~~~~~~~~~........................TTTTTTTTT#########TTTT
..............................~~~~~~~~~~~~~~~~~~~~~~~~~.......................TTTTTTTTT#########TTTT
..............................~~~~~~~~~~~~~~~~~~~~~~~~~~......................TTTTTTTTTT#######TTTTT
..............................~~~~~~~~~~~~~~~~~~~~~~~~~~~.....................TTTTTTTTTT#######TTTTT
.............................~~~~~~~~~~~~~~~~~~~~~~~~~~~~~...................TTTTTTTTTTTTT####TTTTTT
.............................~~~~~~~~~~~~~~~~~~~~~~~~~~~~~~..................TTTTTTTTTTTTTTTTTTTTTTT
.............................~~~~~~~~~~~~~~~~~~~~~~~~~~~~~~~.................TTTTTTTTTTTTTTTTTTTTTTT
............................~~~~~~~~~~~~~~~~~~~~~~~~~~~~~~~~..................TTTTTTTTTTTTTTTTTTTTTT
***************************~~~~~~~~~~~~~~~~~~~~~~~~~~~~~~~~~~*****************^^^^^^^^^^^^^^^^^^^^^^
***************************~~~~~~~~~~~~~~~~~~~~~~~~~~~~~~~~~~*****************^^^^^^^^^^^^^^^^^^^^^^
**************************~~~~~~~~~~~~~~~~~~~~~~~~~~~~~~~~~~~******************^^^^^^^^^^^^^^^^^^^^^
**************************~~~~~~~~~~~~~~~~~~~~~~~~~~~~~~~~~~~******************^^^^^^^^^^^^^^^^^^^^^
*************************~~~~~~~~~~~~~~~~~~~~~~~~~~~~~~~~~~~~******************^^^^^^^^^^^^^^^^^^^^^
*************************~~~~~~~~~~~~~~~~~~~~~~~~~~~~~~~~~~~~*******************^^^^^^^^^^^^^^^^^^^^
*************************~~~~~~~~~~~~~~~~~~~~~~~~~~~~~~~~~~~~********************^^^^^*****^^^^^^^^^
*************************~~~~~~~~~~~~~~~~~~~~~~~~~~~~~~~~~~~~*******************************^^^^^^^^
*************************~~~~~~~~~~~~~~~~~~~~~~~~~~~~~~~~~~~~********************************^^^^^^^
*************************~~~~~~~~~~~~~~~~~~~~~~~~~~~~~~~~~~~~*********************************^^^^^^
*************************~~~~~~~~~~~~~~~~~~~~~~~~~~~~~~~~~~~************************************^^^^
*************************~~~~~~~~~~~~~~~~~~~~~~~~~~~~~~~~~~~*************************************^^^
************************~~~~~~~~~~~~~~~~~~~~~~~~~~~~~~~~~~~~****************************************
*************************~~~~~~~~~~~~~~~~~~~~~~~~~~~~~~~~~~*****************************************