50 50
***^^^^^^^^^^^^^^^^^^^^^^^^^^^^^^^^^^^^^^^^^^^^^^^
***^^^^^^^^^^^^^^^^^^^^^^^^^^^^^^^^^^^^^^^^^^^^^^^
**^^^^^^^^^^^^^^^^^^^^^^^^^^^^^^^^^^^^^^^^^^^^^^^^
***^^^^^^^^^^^^^^^^^^^^^^^^^^^^^^^^^^^^^^^^^^^^^^^
***^^^^^^^^^^^^^^^^^^^^^^^^^^^^^^^^^^^^^^^^^^^^^^^
***^^^^^^^^^^^^^^^^^^^^^^^^^^^^^^^^^^^^^^^^^^^^^^^
***^^^^^^^^^^^^^^^^^^^^^^^^^^^^^^^^^^^^^^^^^^^^^^^
****^^^^^^^^^^^^^^^^^^^^^^^^^^^^^^^^^^^^^^^^^^^^^^
....TTTTTT##^^^^^^^^^^^^^^^^^^^^^^^^^^^^^^^^^^^^^#
....TTTTTT###^^^^^^^^^^^^^^^^^^^^^^^^^^^^^^^^^^^^#
.....TTTTTT###^^^^^^^^^^^^^^^^^^^^^^^^^^^^^^^^^^^#
.....TTTTTTT###^^^^^^^^^^^^^^^^^^^^^^^^^^^^^^^^^##
......TTTTTTT####^^^^^^^^^^^^^^^^^^^^^^^^^^^^^^^##
......TTTTTTTT####^^^^^^^^^^^^^^^^^^^^^^^^^^^^^^##
.......TTTTTTT#####^^^^^^^^^^^^^^^^^^^^^^^^^^^^###
.......TTTTTTTTT####^^^^^^^^^^^^^^^^^^^^^^^^^^^^##
........TTTTTTTT####^^^^^^^^^^^^^^^^^^^^^^^^^^^###
.........TTTTTTTT###^^^^^^^^^^^^^^^^^^^^^^^^^#####
..........TTTTTTTT###^^^^^^^^^^^^^^^^^^^^#########
...........TTTTTTT###^^^^^^^^^^^^^^^^^^^^#######^#
............TTTTTTT###^^^^^^^^^^^^^^^^^^#########^
.............TTTTTT####^^^^^^^^^^^^^^^^#########^^
%.............TTTTTT######^^^^^^^^^^^^##########^^
..............TTTTTTT#########^^^^^^^###########^^
...............TTTTTTT############^############^^^
%..............TTTTTTTTTTT#####################^^^
................TTTTTTTTTTTTT##################^^^
................TTTTTTTTTTTTTTTT###############^^^
..%..............TTTTTTTTTTTTTTTTTTT##########^^^^
..%%%%............TTTTTTTTTTTTTTTTTTTTT#######^^^^
%%%%%...............TTTTTTTTTTTTTTTTTTT#######^^^^
%%%%%%................TTTTTTTTTTTTTTTTTT#####^^^^^
%%%%%%..................TTTTTTTTTTTTTTTT####^^^^^^
.........................TTTTTTTTTTTTTTT####^^^^^^
...........................TTTTTTTTTTTTT####^^^^^^
.............................TTTTTTTTTTTT###^^^^^^
...............................TTTTTTTTTT####^^^^#
................................TTTTTTTTT#########
.................................TTTTTTTTT########
..................................TTTTTTTT########
..................................TTTTTTTTT#######
..................................TTTTTTTTTT######
..................................TTTTTTTTTTTT####
***********************************^^^^^^^^^^^^^^^
***********************************^^^^^^^^^^^^^^^
***********************************^^^^^^^^^^^^^^^
***********************************^^^^^^^^^^^^^^^
************************************^^^^^^^^^^^^^^
*************************************^^^^^^^^^^^^^
**************************************^^^^^^^^^^^^