20 15
..........~~~~......
..TTT.....~~~~......
..TTT......~~~....##
...TT.......~.....##
................####
..............######
.............@@@####
............@@@@....
...........@@@......
%%........@@@.......
%%%%.....^^^........
%%%%....^^^^........
%%%....^^^^^........
%%....******........
%.....*******.......